     WWWWWWWWWWWWWWWWWWWWWWWWWWWWWWWWWWWWWWWWWWWWWWWWWWWWWWWWWWWWWWWWWWWWWWWWWWWWWWWWWWWWWWWWWWWWWWWWWWWWWWWWWWWWWWWWWWWWWWWWWWWWWWWWWWWWWWWWWWWWWWWWWWWWWWWWWWWWWWWWWWWWWWWWWWWWWWWWWWWWWWWWWWWWWWWWWWWWWWWWWWWWWWWWWWWWWWWWWWWWWWWWWWWWWWWWWWWWWWWWWWWWWWWWWWWWWWWWWWWWWWWWWWWWWWWWWWWWWWWWWWWW
     W            W W                                                                                                                 W                                                                                                     W                                           OOOOOOO W
WWWWWWWW                                                                                                                              W                                                                 CCCCCCCCCCCCCCCCCCCCCCCCCCCC        W                                                 O WWWW
W           P      CCPCPPCUP          CPCUPUCPUCPUCPUC                                                                                W               WWWWWWWWWWWWWWWWWWWWWWWWWWWWWWWWWWWWWWWWWWW                                           W                                                   WWWWWWWWWWWWWWWWWWWW
W  CCCCCCCCCCC     WWWWWWWWWWWWWWWWW                                                                                                  W                                                                                                 W   W                                                                      W
W                  WWWWWWWWWWWWWWWWW          WWWWWWWWWWWWWWWWW                                                                       W      PCPUPP                                                                                         W                                                                      W
W                  WWWWWWWWWWWWWWWWW CPUCPCUPUCPUCPUCPCUPCUPCUPCUPCUPUCPUCPU                                                          W                                                                                                     W                                                                      W
WC          PPPPPPPWWWWWWWWWWWWWWWWW                CCCCCCCCPPPPUPPUPUU                                                               W                                                WWWWWWWWWWWWWWWWWWWWWWWWWWWW                         W                                                                      W
W           PPPPPPPWWWWWWWWWWWWWWWWW                  PUCPUPCUCP                                                                      W      WWWWWWWWWWWWWWWWWWWWWWW                                           PPPCPUUUUP                   W                                                 WWWWWWWWWWWWWWWWWWWWWW
W           PPPPPPPWWWWWWWWWWWWWWWWW              WWWWWWWWWWWWWWWWW    CCCCC                                                          W                                                                                                     W                                                 W          W         W
W          PPPPPPPPWWWWWWWWWWWWWWWWW     CCCCCCCCCCCCCCCCCCCC           WW C                                                          W               PUPUCPC                                                                               W                                                 W                    W
WWW                WWWWWWWWWWWWWWWWW                                    WOOO                                                          W                                                        WWWWWWWWWWWWWWWWWWWWWWWWWWWWWWWWW            W                                                            W         W
WOO W                                 UUUUUUUUUUUUUU         PPPPPPPPPP                                                               W        WWWWWWWWWWWWWWWWWWWWWWWWWWWWWWWWWWWWWW                                                       W                                                 W          W         W
WWW            O              O              CCCCCCCCCC                                                                               W                                                                                                     W                                                 W          W         W
W                                                                                                                                     W                                                                                                     W                                                 WWWWWWWWWWWWWWWWWWWWWW
W                                                                                                                                     W                                                                                                     W                                                 W          W         W
W                WWW                                                                                                                  WWWWWWWWWWWWWWWWWWWWWWWWWWWWWWWWWWWWW                              WWWWWWWWWWWWWWWWWWWWWWWWWWWWWWWWWWWW                                                 W          W  CCCC   W
W                WWW                                                                                                                                                                                                                                                                          W          W         W
W                WWW                                                                                                                                                                                                                                                                          W                    W
WWWWWWWW         WWW               WWW                                                                                                                                                                                                                                                                   W         W
W      W         WWW               WWW                                                                                                                                                                                                                                                        W          W         W
W      W         WWW               WWW                                                                                                                                                                                                                                                        WWWWWWWWWWWWWWWWWWWWWW
W      W         WWW               WWW                                                                                                                                                                                                                                                        W          W   PPP   W
W                WWW               WWW                                                                                                                                                                                                                                                        W                    W
W      W         WWW               WWW                                                                                        PCUPCUPUUPC                                                                                                                                                                W         W
WWWWWWWW         WWWWWWWW                                                                                                                                                                                                                                                                     WWWWWWWWWWWWWWWWWWWWWW
W      W                                                                     PCUPCUPUUPC                                                                                                                                                                                                      W          W         W
W      W                                                                                                                                                                                                                                                                                      W          W         W
W      W                                                                                                                                                                                     PCUPCUPUUPC                                                                                                 W         W
W      W                                                                                                                          PCUPCUPUUPC                                                                                                                                                 W          W         W
W      W                                                                                                                                                                                                                                                                                      W                    W
W      W                                                                                                                                                                                                                                                                                      W UUUUUU   W         W
W                                                                                                                                                                                                                                                                                             WWWWWWWWWWWWWWWWWWWWWW
W      W                                                                                                                                                                     PCUPCUPUUPC                                                                                                      W                    W
W      W                                                                                                                                                                                                                                                                                      W                    W
WWWWWWWW                                              PCUPCUPUUPC                                                                                                                                                                                                                                                  W
W      W                                                                                                                                                                                                                                                                                      W          W         W
W                                                                                                                                    PCUPCUPUUPC                                                 PCUPCUPUUPC                                                                                  WWWWWWWWWWWWWWWWWWWWWW
W      W                                                                                                                                                                                                                                                                                                 W         W
W      W                                                                                                                                                                                                                                                                                      W          W PCUPP   W
W      W                                                                                                                                                                                                                                                                                      W          W         W
W      W                                                                                                                                                                                                                                                                                      W          W         W
W      W                                                                                                                                                PCUPCUPUUPC                                                                                                                           W          W         W
W      W                                                                                                                                                                                                                                                                                      W          W         W
W      W                                                                                                                                                                                                                                                                                      W          W         W
W      W                                                                                             WWWWWWWWWWWWWWWWWWWWWWWWWWWWWWWWWWWWWWWWWWWWWWWWWWWWWWWWWWWWWWWWWWWWWWWWWWWWWWWWWWWWWWWWWWWWWWWWWWWWWWWWWWWWW                                                                            W                    W
W      W                                                                                             WWWWWWWWWWWWWWWWWWWWWWWWWWWWWWWWWWWWWWWWWWWWWWWWWWWWWWWWWWWWWWWWWWWWWWWWWWWWWWWWWWWWWWWWWWWWWWWWWWWWWWWWWWWWW                                                                            W PPPPP    W         W
WWWWWWWWWWWWWWWWWWWWWWWWWWWWWWWWWWWWWWWWWWWWWWWWWWWWWWWW                                             WWWWWWWWWWWWWWWWWWWWWWWWWWWWWWWWWWWWWWWWWWWWWWWWWWWWWWWWWWWWWWWWWWWWWWWWWWWWWWWWWWWWWWWWWWWWWWWWWWWWWWWWWWWWW                                                                            W          W         W
W                                                                                                    WWWWWWWWWWWWWWWWWWWWWWWWWWWWWWWWWWWWWWWWWWWWWWWWWWWWWWWWWWWWWWWWWWWWWWWWWWWWWWWWWWWWWWWWWWWWWWWWWWWWWWWWWWWWW                                                                            WWWWWWWWWWWWWWWWWWWWWW
W                                                                                                               PCUPCUPCUPUCPUP      PPPPP                                                                                                                                                    W                    W
W   WWWWWWWWWWWWWWWWWWWWWWWWW   WWWWWWWWWW   WWWWWWWWWWW                                                                                                                                                                                                                                      W    PCUPCUPUUPC     W
W          W                       W                   W                                             WWWWWWWWWWWWWWWWWWWWWWWWWWWWWWWWWWWWWWWWWWWWWWWW      PPPPWWWWWWWWWWWWWWWWWWWWWWWWWWWWWWWWWWWWWWWWWWWWWWWWWWW                                                                            W                    W
W          W                       W                   W                                             WWWWWWWWWWWWWWWWWWWWWWWWWWWWWWWWWWWWWWWWWWWWWWWW          WWWWWWWWWWWWWWWWWWWWWWWWWWWWWWWWWWWWWWWWWWWWWWWWWWW                                                                            W                    W
W      PUCUW                       W                   W                                             WWWWWWWWWWWWWWWWWWWWWWWWWWWWWWWWWWWWWWWWWWWWWWWW          WWWWWWWWWWWWWWWWWWWWWWWWWWWWWWWWWWWWWWWWWWWWWWWWWWW                                                                                                 W
W          W     PCUPCUPUUPC       W                   W                                             WWWWWWWWWWWWWWWWWWWWWWWWWWWWWWWWWWWWWWWWWWWWWWWW          WWWWWWWWWWWWWWWWWWWWWWWWWWWWWWWWWWWWWWWWWWWWWWWWWWW                                                                            W                    W
W          W                       W                   W                                                                                                                                                                                                                                      W                    W
W          W                       W CPUPCUPC          W                                                                                                                                                                                                                                      W                    W
W          W                       W                   W                                                                                                                                                                                                                                      W                    W
W          W                       W                   W                                                                                                                                                                                                                                      W                    W
WWWWWWWWWWWWWWWWWWWWWWWWWWWWWWWWWWWWWWWWWWWWWWWWWWWWWWWW                                                                                                                                                                                                                                      W                    W
W                                                                                                                                                                                                                                                                                             WWWWWWWWWWWWWWWWWWWWWW
W                                                                                                                                                                                                                                                                                                                  W
W                                                                                                                                                                                                                                                                                                                  W
W                                                                                                                                                                                                                                                                                                                  W
W                                                                                                                                                                                                                                                                                                                  W
W                                                                                                                                                                                                                                                                                                                  W
W                                                                                                                                                                                                                                                                                                                  W
W                                                                                                                                                                                                                                                                                                                  W
W                                                                                                                                                                                                                                                                                                                  W
W                                                                                                                                                                                                                                                                                                     W            W
W                                                                                                                                                                                                                                                                                                     W            W
W                                                                                                                                                                                                                                                                                                     W            W
W                                                                                                                                                                                                                                                                                                     W            W
W OOOOOOO                                                                                                                                                                                                                                                                                             WOOOOOOOOOOOOW
WWWWWWWWWWWWWWWWWWWWWWWWWWWWWWWWWWWWWWWWWWWWWWWWWWWWWWWWWWWWWWWWWWWWWWWWWWWWWWWWWWWWWWWWWWWWWWWWWWWWWWWWWWWWWWWWWWWWWWWWWWWWWWWWWWWWWWWWWWWWWWWWWWWWWWWWWWWWWWWWWWWWWWWWWWWWWWWWWWWWWWWWWWWWWWWWWWWWWWWWWWWWWWWWWWWWWWWWWWWWWWWWWWWWWWWWWWWWWWWWWWWWWWWWWWWWWWWWWWWWWWWWWWWWWWWWWWWWWWWWWWWWWWWWWWWWWWWWWWWWWWWWWWWW