WWWWWWWWWWWWWWWWWWWWWWWWWWWWWWWWWWWWWWWWWWWWWWWWWWWWWWWWWWWWWWWWWWWWWWWWWWWWWWWWWWWWWWWWWWWWWWWWWWWWWWWWWWWWWWWWWWWWWWWWWWWWWWWWWWWWWWWWWWWWWWWWWWWWWWW
W                 W W               W                                                      W                                                          W
W                                   W                                                      W                                                          W
W           P      CCPCPPCUP        W CPCUPUCPUCPUCPUC                                     W                                                          W
W  CCCCCCCCCCC     WWWWWWWWWWWWWWWWWW                                                      W                UUUUUUUUUUUUU                             W
W                  WWWWWWWWWWWWWWWWWW         WWWWWWWWWWWWWWWWW                            W                UCCCCCCCCCCCU                             W
W                                   WCPUCPCUPUCPUCPUCPCUPCUPCUPCUPCUPUCPUCPU               W                UCCCCPPCCCCCU                             W
WC          PPPPPPP       PPP                       CCCCCCCCPPPPUPPUPUU                    W                UCCCCPPCCCCCU                             W
W           PPPPPPP                                   PUCPUPCUCP                           W                UCCCCPPCCCCCU                             W
W           PPPPPPP                 W             WWWWWWWWWWWWWWWWW    CCCCC               W                UCCCCPPCCCCCU                             W
W          PPPPPPPPWWWWWWWWWWWWWWWWWW    CCCCCCCCCCCCCCCCCCCC           WW C               W                UCCCCCCCCCCCU                             W
WWW                WWWWWWWWWWWWWWWWWW                                                      W                UUUUUUUUUUUUU                             W
W   W                               W UUUUUUUUUUUUUU         PPPPPPPPPP                    W                                                          W
WWWPPPP        C              C     W        CCCCCCCCCC                                    W                                                          W
WWWWWWWWWWWWWWWWWWWWWWWWWWWWWWWWWWWWWWWWWWWWWWWWWWWWWWWWWWWWWWWWWWWWWWWWWW    WWWWWWWWWWWWWW                                                          W
W                                                                               W          W                                                          W
W                WWW                                                            W  PP      WWWWWWWWWWWWWWWWWWWWWWWWWWWWWWWWWWWWWWWWWWWWWWWWWWWWW  WWWWW
W                WWW                                                            W  PP      W                                                          W
W                WWW                                                            W  PP      W                                                          W
WWWWWWWW         WWW               WWW                                          W  PP      W                                                          W
W      W         WWW               WWW                                          W  PP      W                                                          W
W      W         WWW               WWW             CCCCCC                       W          W                                                          W
W      W         WWW               WWW             CCCCCC                       WWWWWWWW   W                                                          W
W UUU            WWW               WWW             CCCCCC                                  W                                                          W
W      W         WWW               WWW                                                     W                                  PCUPCUPU                W
WWWWWWWW         WWWWWWWW                                                                  W                                                          W
W      W                                                                     PCUPCUPUUPC   W                                                          W
W  CC  W                                                                                                                                              W
W  CC  W                                                                                                                                              W
W  CC  W                            UPCUPCUPCUPCUPC                                                                               PCUP                W
W  CC  W                                                                                                                                              W
W      W                                                                                   W  PP                                                      W
W                                                                                          W  PP                                                      W
W CCCC W                                                                                   W  PP                                                      W
W      W                                                                                   W  PP                                                      W
WWWWW WWWWWWWWWWWWWWWWWWWWWWWWWWWW  WWWWWWWW          PCUPCUPUUPC                          W  PP                                                      W
W      W                                   WWWWWWWWWWWWWWWWWWWWWWWWWWWWWWWWWWWWWWWWWWWW  WWW  PP                                                      W
W                                          W                                     W         W                                         P                W
W      W                                   W            PP                       W         W                                                          W
W      W          WWWWWWWWWWWWWWWWWWWWWWW  W            PP                                 W                                                          W
W UUUU W                                   W            PP                       W         W                                                          W
W      W                                   W                                     W         W                                                          W
W      W                         PPPPP                         O                 W         W                                                      OOOOW
WWWWWWWWWWWWWWWWWWWWWWWWWWWWWWWWWWWWWWWWWWWWWWWWWWWWWWWWWWWWWWWWWWWWWWWWWWWWWWWWWWWWWWWWWWWWWWWWWWWWWWWWWWWWWWWWWWWWWWWWWWWWWWWWWWWWWWWWWWWWWWWWWWWWWWW                                                                                                                         






























